.............
.............
...B..P.RBB..
.BBB..BBBBB..
.............
...BBBGB.....
.............