.................................
.................................
.................................
.................................
.................................
.................................
........P........................
.......BBB.......................
.........BBBBB...R...............
.............BBBBBBB.............
.................................
.................................
...........BBBB..BBBBBBBBBB......
.................................
.................................
.........BBB.BBB.BBB.BGGB........
.................................
.................................
.................................
.................................
.................................
.................................
.................................