................................
................................
........P.......................
........P.......................
....PPPPP.......................
..PPP.P.P...R...................
BBBBBBBBBBBBBB..................
................................
................................
................................
........G.......................
................................
................................
..........BBBB..................