....................
....................
....................
....................
....P...............
..BBBBBBB...........
....................
..........M.........
....BBGBBBBBB.......
....................
....................
....................