...................................
...................................
...................................
.....PP.PP.......B.................
.....P...P.......B.................
.....PPPPP.......B.................
...BBBBBBBBB..S..B.................
...........B.....B.................
...........B.....B.................
...........B.....B.................
...........B.....B.................
........RRRR.....S.................
...........BBBBBBB.........G.......
...................................
...................................
......................G...G........
...................................
...................................