.......PP.......................
........P.......................
....PPPPP.......................
..PPP.P.P..M....................
BBBBBBBBBBBB...BBBBBBBBBBBBBBBBB
...........B...B................
...........B...B................
................................
................................
................................
................................
...........BBBBBBBBBBB...B......
.....................B...B......
.....................BGBGB......