.............
.............
...B..P.RBB..
.BBB..BBBBB..
.............
...BBGGB.....
.............