.................................
.................................
....PP..R.R......................
...BBBBBBBBBBBBBBBBB.............
.................................
........................RRR......
.................................
...........................B.....
.............B.B.B.B.BBBBBBB.....
.................................
.................................
.................................
.................................
........B........................
........BBBBBBBBBBBB.............
........B........................
.................................
.................................
.................................
.................................
....BGGGGGB....BBBBBBBBBBBB......
.................................
.................................