.............
.............
...B..P.RBB..
.BBB..BBBBB..
.............
...BBBBB..... 
.............